0000000000000000
0001000000000000
0001111111111000
0011000010001000
0010000000001130
0011100000001000
0210111111101000
0000000000000000
