0000000000000
0101111101110
0100000101010
0101011111010
0101010101000
0101110101110
0101000100000
0211110111130
0101000101000
0101110101110
0100000001000
0111111101110
0000000000000