00000000000
05111101010
01010101010
01010111110
00000200000
01110101010
01000101040
01011111110
01010000000
03111111160
00000000000
