00000000000000000
03110101110111040
01010101000100010
01011111111101110
01010001010000010
01011201011111010
00010100000100010
01110111110111110
01010101000100010
01010101010111010
00010001010001000
01110111111101610
05010100000100010
01010111010111010
00010100010100000
01110111110111110
00000000000000000
