00000000000
01110101110
01010101010
01011101110
01010101010
01110111310
01000000010
01110111110
01000100000
02111111110
00000000000
