00000000000000000
01011111010101110
01010100010100010
02110111111111110
01010000000000010
01011111111101030
00000100000101000
01111111010111110
01010000010100010
01011101111111010
00000000000000000
