01010101010
01010101010
02111111110
01000001010
01110111010
01010001000
01010111110
01010100030
01010101110
01010101010
01110111110
